day,add_num,remove_num,net_add_num,total_num,tvl,ssv_price
2023-06-18,1,0,1,1,55461.23888888887,17.72510416666666
2023-06-19,4,0,4,5,276291.31666666677,17.237916666666646
2023-06-20,1,0,1,6,335138.6933333344,17.484895833333336
2023-06-25,27,0,27,33,2.0089379933333371e+06,18.52340277777779
2023-07-31,21,0,21,54,3.222809400000001e+06,18.61486111111112
2023-08-07,25,0,25,79,4.629240244444448e+06,17.195590277777764
2023-08-08,145,0,145,224,1.3197132479999995e+07,17.179722222222217
2023-09-15,1,0,1,225,1.1721663249999998e+07,15.789131944444414
2023-09-20,2,1,1,226,1.1807801911111088e+07,16.72506944444443
2023-09-21,11,0,11,237,1.2156200576666689e+07,16.34475694444439
2023-09-22,89,0,89,326,1.6635269628888924e+07,16.05656250000001
2023-09-28,2,0,2,328,1.7112033697777797e+07,16.076423611111128
2023-09-29,1,0,1,329,1.753163209777783e+07,16.214791666666653
2023-10-09,19,0,19,348,1.7861064040000018e+07,15.326666666666643
2023-10-13,0,1,-1,347,1.7175928221111115e+07,13.761840277777848
2023-10-16,8,2,6,353,1.786305550333334e+07,13.527638888888903
2023-10-18,8,0,8,361,1.8160795312222272e+07,12.76899305555549
2023-10-19,32,0,32,393,1.9605414586666655e+07,12.2402083333334
2023-10-20,1,0,1,394,2.0157597728888936e+07,12.091875000000007
2023-10-23,22,1,21,415,2.2445796977777805e+07,12.764513888888958
2023-10-25,69,0,69,484,2.770824442222228e+07,14.310208333333275
2023-10-26,3,0,3,487,2.812799665333345e+07,14.342986111111173
2023-10-29,200,0,200,687,3.934056417666665e+07,14.351875000000017
2023-10-31,1,0,1,688,3.971774922666662e+07,14.583402777777732
2023-11-02,2,0,2,690,4.036869379999998e+07,14.596006944444447
2023-11-03,2,2,0,690,3.986503213333332e+07,14.048055555555553
2023-11-04,1,1,0,690,4.06037009e+07,15.414479166666668
2023-11-05,1,0,1,691,4.162950460333337e+07,15.387222222222226
2023-11-07,13,0,13,704,4.2482176000000045e+07,16.618819444444433
2023-11-08,25,0,25,729,4.406063445000001e+07,16.615381944444444
2023-11-09,137,0,137,866,5.437276452444442e+07,15.942569444444459
2023-11-10,38,0,38,904,6.076774482666664e+07,19.767743055555528
2023-11-12,15,0,15,919,6.0377175756666675e+07,19.468506944444474
2023-11-13,1,0,1,920,6.081713564444435e+07,19.351354166666663
2023-11-14,101,1,100,1020,6.6430894333333336e+07,18.250034722222217
2023-11-15,76,0,76,1096,7.042226831111112e+07,18.662743055555545
2023-11-16,20,0,20,1116,7.239500059999995e+07,18.443645833333317
2023-11-17,102,0,102,1218,7.650994890000005e+07,17.55173611111108
2023-11-19,1,0,1,1219,7.675784707444446e+07,16.711597222222164
2023-11-20,0,1,-1,1218,7.885098685333304e+07,17.58076388888884
2023-11-21,36,2,34,1252,8.025090466666712e+07,17.23541666666661
2023-11-22,253,2,251,1503,9.710803842000006e+07,17.368541666666697
2023-11-23,166,0,166,1669,1.1024800364333293e+08,19.0265277777778
2023-11-24,143,0,143,1812,1.2113098394666664e+08,22.207604166666595
2023-11-26,20,0,20,1832,1.2170874901333341e+08,23.071736111111104
2023-11-27,280,0,280,2112,1.3745088661333296e+08,23.56548611111111
2023-11-28,21,0,21,2133,1.3890428273999962e+08,25.26232638888895
2023-11-29,3,0,3,2136,1.3993569917333332e+08,25.58298611111094
2023-12-01,54,0,54,2190,1.4639972366666722e+08,24.902256944444428
2023-12-02,1,0,1,2191,1.4819962220777744e+08,24.981736111111104
2023-12-05,34,0,34,2225,1.592658634166666e+08,26.880659722222255
2023-12-06,6,0,6,2231,1.6212167340444446e+08,26.69423611111119
2023-12-07,4,1,3,2234,1.634236754066666e+08,26.124965277777836
2023-12-08,15,0,15,2249,1.7007220374444476e+08,26.01430555555561
2023-12-09,23,4,19,2268,1.7144264591999978e+08,25.639236111111202
2023-12-10,8,0,8,2276,1.714520612088889e+08,25.16968750000004
2023-12-11,5,3,2,2278,1.632737086377784e+08,23.40708333333334
2023-12-12,7,16,-9,2269,1.607629585788889e+08,23.92895833333333
2023-12-13,0,20,-20,2249,1.5846084164444485e+08,23.211909722222234
2023-12-14,20,3,17,2266,1.6546183954666686e+08,23.763090277777753
2023-12-16,0,47,-47,2219,1.5944971157111233e+08,22.00815972222221
2023-12-17,0,132,-132,2087,1.484747824355558e+08,21.766423611111083
2023-12-19,4,0,4,2091,1.4821465232e+08,21.51954861111115
2023-12-20,11,5,6,2097,1.4838830543999973e+08,22.245937499999982
2023-12-21,2,0,2,2099,1.495028119344446e+08,22.690173611111096
2023-12-22,65,24,41,2140,1.57358040111111e+08,24.76621527777784
2023-12-24,5,4,1,2141,1.576213168411114e+08,24.43520833333327
2023-12-25,7,0,7,2148,1.568003173733331e+08,24.45041666666675
2023-12-28,3,0,3,2151,1.6422019820000046e+08,26.366493055555587
2023-12-29,31,1,30,2181,1.633067297299996e+08,26.199409722222104
2023-12-31,4,0,4,2185,1.606893501166667e+08,26.611666666666608
2024-01-01,1,0,1,2186,1.6142364708666673e+08,28.58569444444443
2024-01-02,2,0,2,2188,1.6682772611555544e+08,28.13888888888889
2024-01-03,5,5,0,2188,1.607465326266668e+08,28.146736111111107
2024-01-04,81,2,79,2267,1.6316250132777756e+08,32.32302083333333
2024-01-05,24,8,16,2283,1.6438488847999987e+08,32.76159722222219
2024-01-06,14,4,10,2293,1.649438874755556e+08,31.3163888888889
2024-01-07,9,0,9,2302,1.6538620781333333e+08,32.183263888888895
2024-01-08,233,0,233,2535,1.832072779333332e+08,30.265069444444418
2024-01-09,2,0,2,2537,1.8647909267888904e+08,29.814826388888914
2024-01-10,169,5,164,2701,2.089593056822221e+08,34.07475694444444
2024-01-11,138,17,121,2822,2.357976721377779e+08,36.19222222222223
2024-01-12,111,5,106,2928,2.4436925658666673e+08,36.43927083333335
2024-01-13,33,0,33,2961,2.4187113726999992e+08,35.90031249999999
2024-01-15,3,0,3,2964,2.3926801079999986e+08,34.02593749999999
2024-01-16,2,0,2,2966,2.418495052844443e+08,35.54729166666667
2024-01-17,5,2,3,2969,2.4250755052444467e+08,35.700138888888866
2024-01-18,246,1,245,3214,2.5807052978666598e+08,32.96798611111118
2024-01-19,230,248,-18,3196,2.5306625438222265e+08,31.311527777777712
2024-01-20,122,16,106,3302,2.6149868339111063e+08,30.595659722222276
2024-01-21,75,43,32,3334,2.641488673577776e+08,30.66590277777783
2024-01-22,77,77,0,3334,2.5511013775111115e+08,30.97479166666675
2024-01-23,13,1,12,3346,2.4199191406444398e+08,28.814722222222134
2024-01-24,26,9,17,3363,2.4003794013666672e+08,29.02711805555555
2024-01-25,3,0,3,3366,2.3883170256000006e+08,28.438194444444424
2024-01-26,2,1,1,3367,2.4153314417555535e+08,29.55166666666666
2024-01-27,38,3,35,3402,2.470774395599998e+08,30.12888888888883
2024-01-28,4,0,4,3406,2.4812081403777754e+08,30.711111111111094
2024-01-29,5,160,-155,3251,2.3691070095555523e+08,30.46107638888888
2024-01-30,8,0,8,3259,2.4315790079999974e+08,31.666319444444493
2024-01-31,51,1,50,3309,2.4581231517333388e+08,30.94999999999999
2024-02-01,84,1,83,3392,2.4754506197333276e+08,29.61597222222229
2024-02-02,79,0,79,3471,2.561626423633326e+08,29.935972222222226
2024-02-03,2,0,2,3473,2.5691739772000065e+08,29.67746527777772
2024-02-04,1,1,0,3473,2.5571375239222094e+08,29.09694444444449
2024-02-05,50,0,50,3523,2.597327992133343e+08,29.08673611111111
2024-02-06,32,0,32,3555,2.6596113535000107e+08,29.388368055555638
2024-02-07,7,0,7,3562,2.7188693361555576e+08,28.957152777777893
2024-02-08,2,1,1,3563,2.7684509208222216e+08,29.25048611111112
2024-02-09,4,0,4,3567,2.82578687236666e+08,29.969722222222092
2024-02-10,2,0,2,3569,2.8523739468333316e+08,30.283715277777855
2024-02-11,3,0,3,3572,2.8762119059999955e+08,30.43225694444429
2024-02-12,5,0,5,3577,2.906476604811131e+08,30.252569444444386
2024-02-13,194,0,194,3771,3.196119597600004e+08,31.40760416666662
2024-02-14,0,28,-28,3743,3.247234077088884e+08,31.886111111110985
2024-02-15,3,0,3,3746,3.364078651111114e+08,32.54857638888878
2024-02-16,2,2,0,3746,3.3752821462888867e+08,32.133159722222295
2024-02-18,2,4,-2,3744,3.368272335999994e+08,31.79704861111115
2024-02-19,1,0,1,3745,3.492910401555544e+08,34.312812499999986
2024-02-20,2,1,1,3746,3.525908889533346e+08,33.72229166666673
2024-02-21,4,0,4,3750,3.532179083333332e+08,31.941215277777747
2024-02-22,10,0,10,3760,3.576328720888888e+08,31.967465277777734
2024-02-23,15,0,15,3775,3.561271412222223e+08,31.18208333333322
2024-02-24,4,14,-10,3765,3.5697860050000066e+08,32.014652777777705
2024-02-26,2,0,2,3767,3.7589767504111046e+08,34.35170138888878
2024-02-27,12,8,4,3771,3.908259874799987e+08,34.19291666666661
2024-02-28,9,0,9,3780,4.0022595480000144e+08,33.62006944444436
2024-03-01,6,0,6,3786,4.128683143466662e+08,32.95340277777774
2024-03-02,0,1,-1,3785,4.150508870666664e+08,33.42138888888901
2024-03-04,2,0,2,3787,4.2758809977333254e+08,34.809513888888894
2024-03-06,0,1,-1,3786,4.564784532866659e+08,35.59017361111115
2024-03-07,15,0,15,3801,4.651402671300007e+08,36.27996527777786
2024-03-08,7,19,-12,3789,4.763043492500002e+08,36.73368055555552
2024-03-09,2,2,0,3789,4.7523092554999906e+08,36.72100694444442
2024-03-10,0,6,-6,3783,4.752402619033334e+08,37.69795138888886
2024-03-11,801,0,801,4584,5.843133578399998e+08,36.62024305555558
2024-03-12,225,0,225,4809,6.160854089366666e+08,39.63555555555563
2024-03-13,33,148,-115,4694,6.035347269666659e+08,51.02104166666665
2024-03-14,73,1,72,4766,5.989018140511094e+08,49.6030555555555
2024-03-15,92,7,85,4851,5.779297493199998e+08,44.843194444444315
2024-03-16,13,2,11,4862,5.726210235777761e+08,46.42510416666644
2024-03-17,81,0,81,4943,5.669162069911106e+08,45.180694444444526
2024-03-18,1192,78,1114,6057,6.914864283699996e+08,48.97263888888878
2024-03-19,253,399,-146,5911,6.286332014877795e+08,47.885347222222215
2024-03-20,1532,1,1531,7442,7.832825725777808e+08,50.51701388888891
2024-03-21,603,6,597,8039,9.03977287694441e+08,58.09010416666651
2024-03-22,14,265,-251,7788,8.51272462773332e+08,59.65638888888876
2024-03-23,53,0,53,7841,8.450061872111102e+08,59.73010416666664
2024-03-24,321,80,241,8082,8.733851913999988e+08,59.020312499999676
2024-03-25,483,80,403,8485,9.5507163771111e+08,62.35569444444439
2024-03-26,44,4,40,8525,9.859096857499973e+08,62.38003472222248
2024-03-27,426,0,426,8951,1.0202676610955553e+09,60.51795138888893
2024-03-28,324,0,324,9275,1.055373157416661e+09,59.825138888888624
2024-03-29,402,0,402,9677,1.095385176413331e+09,59.7835069444446
2024-03-30,170,166,4,9681,1.0917105469433322e+09,57.10062499999999
2024-03-31,12,1,11,9692,1.1185460848577766e+09,55.56086805555546
2024-04-01,251,14,237,9929,1.1243757140133336e+09,52.4917361111111
2024-04-02,3,0,3,9932,1.0600006676711092e+09,47.89819444444445
2024-04-03,1372,1,1371,11303,1.2003658024922228e+09,47.38972222222223
2024-04-04,4,0,4,11307,1.207891192950001e+09,49.90868055555551
2024-04-05,1,0,1,11308,1.1946743562355568e+09,49.89243055555557
2024-04-06,7,0,7,11315,1.2098894650888898e+09,50.50392361111113
2024-04-07,16,4,12,11327,1.2309547903588884e+09,52.039687499999964
2024-04-08,146,0,146,11473,1.3138583469122224e+09,53.47802083333339
2024-04-09,290,0,290,11763,1.3561558125500007e+09,51.56972222222221
2024-04-10,1998,16,1982,13745,1.5441948383944433e+09,49.590555555555554
2024-04-11,1627,12,1615,15360,1.7412017151999998e+09,50.62899305555548
2024-04-12,221,1,220,15580,1.7145186015333374e+09,47.00993055555558
2024-04-13,1,0,1,15581,1.5978208510466628e+09,39.11222222222221
2024-04-14,2,2,0,15581,1.524526667127776e+09,37.68923611111102
2024-04-15,1278,2,1276,16857,1.7091214154800012e+09,39.22267361111113
2024-04-16,210,1,209,17066,1.67900266621111e+09,38.117673611111364
2024-04-17,2,1,1,17067,1.6630064509233317e+09,36.9360416666665
2024-04-18,6,0,6,17073,1.6565973254600015e+09,35.811840277777655
2024-04-19,163,1,162,17235,1.6892928912000017e+09,37.03572916666675
2024-04-20,100,0,100,17335,1.7128085587777758e+09,39.04857638888892
2024-04-21,323,21,302,17637,1.7850922896366663e+09,40.552951388888914
2024-04-22,230,107,123,17760,1.816255408e+09,42.90784722222221
2024-04-23,389,0,389,18149,1.8603766752599995e+09,43.86027777777776
2024-04-24,184,1,183,18332,1.8869013126844447e+09,45.47999999999997
2024-04-25,298,90,208,18540,1.867716880800001e+09,44.97364583333332
2024-04-26,360,0,360,18900,1.9000312379999993e+09,44.671979166666674
2024-04-27,8,1,7,18907,1.9121024508988907e+09,46.620277777777794
2024-04-28,126,0,126,19033,2.01295985607111e+09,53.04756944444446
2024-04-29,224,2,222,19255,1.9675705704166663e+09,48.884027777777774
2024-04-30,113,1,112,19367,1.9025634460544417e+09,42.42840277777781
2024-05-01,0,16,-16,19351,1.8197495705455518e+09,40.770937499999874
2024-05-02,5,4,1,19352,1.8357735094222255e+09,41.35517361111112
2024-05-03,9,2,7,19359,1.8803420791199958e+09,42.71267361111108
2024-05-04,4,1,3,19362,1.9344554838000045e+09,44.55173611111119
2024-05-06,85,0,85,19447,1.9460926861011033e+09,44.379479166666655
2024-05-07,10,0,10,19457,1.9126551391933424e+09,43.01131944444432
2024-05-08,345,3,342,19799,1.9038756018100011e+09,42.20274305555548
2024-05-09,37,16,21,19820,1.9026096466444457e+09,43.18871527777787
2024-05-10,134,1,133,19953,1.9058556449100041e+09,40.94746527777788
2024-05-11,8,0,8,19961,1.8641683915088866e+09,35.705624999999884
2024-05-12,2,5,-3,19958,1.8700606305755568e+09,35.869097222222244
2024-05-13,22,6,16,19974,1.8812294405333302e+09,35.61663194444458
2024-05-14,4,61,-57,19917,1.8563620154299989e+09,34.96135416666668
2024-05-15,160,80,80,19997,1.8848973563133316e+09,35.577499999999965
2024-05-16,496,1,495,20492,1.957022521297774e+09,36.10868055555544
2024-05-17,5,1,4,20496,1.9901046211200027e+09,38.739409722222256
2024-05-18,53,1,52,20548,2.0477947301777794e+09,42.22940972222222
2024-05-19,59,9,50,20598,2.041616291579999e+09,43.084270833333264
2024-05-20,69,11,58,20656,2.1075393227200053e+09,43.92607638888902
2024-05-21,87,11,76,20732,2.471531448626657e+09,47.139305555555445
2024-05-22,111,107,4,20736,2.4884101555199976e+09,44.00565972222226
2024-05-23,57,6,51,20787,2.5254235547233377e+09,44.93184027777782
2024-05-24,152,0,152,20939,2.5004437835077844e+09,46.53031250000015
2024-05-25,16,0,16,20955,2.512403962566669e+09,48.904583333333306
2024-05-26,28,22,6,20961,2.5523504012999916e+09,49.343680555555494
2024-05-27,242,2,240,21201,2.6518001145666766e+09,47.41996527777784
2024-05-28,43,2,41,21242,2.6228477128244495e+09,45.04065972222218
2024-05-29,12,0,12,21254,2.589536090628887e+09,44.66875000000009
2024-05-30,1031,4,1027,22281,2.684177042703333e+09,43.65496527777769
2024-05-31,456,429,27,22308,2.689811192639998e+09,44.059236111111055
2024-06-01,40,31,9,22317,2.7085607539966693e+09,44.84069444444448
2024-06-02,11,0,11,22328,2.7123772819111094e+09,44.14086805555566
2024-06-03,54,55,-1,22327,2.7131920238977795e+09,44.582534722222356
2024-06-04,0,2,-2,22325,2.703148853277775e+09,44.5806597222222
2024-06-05,0,2,-2,22323,2.7293661665900025e+09,45.14909722222225
2024-06-06,4,1,3,22326,2.74394691470667e+09,44.405833333333234
2024-06-07,1053,44,1009,23335,2.821394791583338e+09,42.112638888888846
2024-06-08,0,41,-41,23294,2.749806022608895e+09,39.26208333333341
2024-06-09,1,0,1,23295,2.753644903133334e+09,38.835833333333355
2024-06-10,501,0,501,23796,2.804200753200009e+09,38.45527777777773
2024-06-11,2,0,2,23798,2.693373104215554e+09,36.50263888888889
2024-06-12,538,17,521,24319,2.765537116715555e+09,37.86812500000004
2024-06-13,52,2,50,24369,2.7274815337933345e+09,37.5490625
2024-06-14,50,1,49,24418,2.718159668266667e+09,38.5688888888889
2024-06-15,3,0,3,24421,2.7663962545344453e+09,40.757395833333334
2024-06-17,205,204,1,24422,2.7755470307133327e+09,39.771041666666676
2024-06-18,62,2,60,24482,2.693556944664446e+09,36.495173611111106
2024-06-19,53,0,53,24535,2.7838000112611094e+09,40.235138888888876
2024-06-20,459,2,457,24992,2.842623541511111e+09,40.829444444444434
2024-06-21,646,84,562,25554,2.867694042726666e+09,40.01017361111113
2024-06-22,205,200,5,25559,2.8637896777666655e+09,39.43006944444443
2024-06-24,1195,151,1044,26603,2.849872593734442e+09,36.68093749999999
2024-06-25,495,381,114,26717,2.8930866504344482e+09,37.88361111111108
2024-06-26,1014,194,820,27537,2.981518037516672e+09,37.902881944444474
2024-06-27,1109,55,1054,28591,3.1240304324844484e+09,39.284166666666685
2024-06-28,525,251,274,28865,3.1638671205111127e+09,39.09861111111112
2024-06-29,208,100,108,28973,3.1414792932444463e+09,37.387777777777764
2024-06-30,184,8,176,29149,3.16667817970667e+09,37.91878472222222
2024-07-01,67,44,23,29172,3.242760362746667e+09,40.63881944444445
2024-07-02,157,36,121,29293,3.2213068473788905e+09,38.810381944444444
2024-07-03,1146,5,1141,30434,3.244345286808893e+09,38.038506944444485
2024-07-04,698,0,698,31132,3.1617851180666647e+09,35.46822916666665
2024-07-05,141,4,137,31269,2.960658639446666e+09,29.075138888888898
2024-07-06,137,134,3,31272,3.0193654225866656e+09,29.284305555555555
2024-07-07,14,12,2,31274,3.011471312871109e+09,30.65583333333334
2024-07-08,98,28,70,31344,2.9860146133866653e+09,30.08749999999999
2024-07-09,6,0,6,31350,3.0766650695000005e+09,31.74784722222222
2024-07-10,157,1,156,31506,3.12359134147333e+09,32.43107638888887
2024-07-11,548,40,508,32014,3.1982467632844434e+09,32.586909722222245
2024-07-12,103,3,100,32114,3.189067924400005e+09,32.59861111111118
2024-07-14,80,298,-218,31896,3.2656287231999907e+09,33.16243055555563
2024-07-15,169,0,169,32065,3.451947848616672e+09,34.84309027777783
2024-07-16,225,105,120,32185,3.5406914470888853e+09,34.56211805555541
2024-07-17,83,0,83,32268,3.5684348685599957e+09,34.99993055555553
2024-07-18,180,19,161,32429,3.558404083094456e+09,35.12614583333343
2024-07-19,926,4,922,33351,3.680425481109997e+09,34.816979166666655
2024-07-21,1,9,-8,33343,3.7398108973999953e+09,34.43496527777781
2024-07-22,1,0,1,33344,3.722703550719988e+09,33.66923611111118
2024-07-23,52,0,52,33396,3.7116057992933307e+09,33.38628472222222
2024-07-24,300,954,-654,32742,3.5921906677999916e+09,32.536805555555645
2024-07-25,672,0,672,33414,3.3955791302999935e+09,29.810381944444483
2024-07-26,1000,332,668,34082,3.544232509060018e+09,30.759583333333516
2024-07-27,423,0,423,34505,3.612785794605538e+09,31.164097222222214
2024-07-28,207,0,207,34712,3.615281142551115e+09,30.77031249999995
2024-07-29,1108,42,1066,35778,3.821681850093335e+09,31.53468750000005
2024-07-30,5,9,-4,35774,3.7942997891933393e+09,31.575277777777764
2024-07-31,243,1,242,36016,3.797208818631111e+09,31.362673611111106
2024-08-01,1620,13,1607,37623,3.8175405131933346e+09,29.144965277777793
2024-08-02,504,3,501,38124,3.7881992660400085e+09,27.937118055555498
2024-08-03,158,1,157,38281,3.6269444039555497e+09,25.14472222222219
2024-08-04,234,22,212,38493,3.515935949889997e+09,23.195486111111112
2024-08-05,16,0,16,38509,2.924715077617773e+09,17.80635416666665
2024-08-06,711,29,682,39191,3.1293881556966686e+09,19.74222222222222
2024-08-07,516,2,514,39705,3.1076634981000047e+09,19.23968749999997
2024-08-08,190,4,186,39891,3.1824389133466663e+09,19.758784722222224
2024-08-09,519,41,478,40369,3.402436260618888e+09,20.857083333333325
2024-08-10,22,0,22,40391,3.379645298293326e+09,20.87065972222222
2024-08-11,2,0,2,40393,3.4038846735722203e+09,20.115034722222262
2024-08-12,24,1,23,40416,3.394398877973341e+09,19.996145833333323
2024-08-13,579,44,535,40951,3.5098136111411157e+09,20.427812500000005
2024-08-14,505,0,505,41456,3.5794878728711033e+09,20.538611111111063
2024-08-15,173,2,171,41627,3.49582227811666e+09,19.203541666666673
2024-08-16,19,2,17,41644,3.4654543222933173e+09,18.992465277777747
2024-08-18,1,0,1,41645,3.5203561013166766e+09,19.306666666666715
2024-08-19,1,2009,-2008,39637,3.313680285283325e+09,19.15836805555553
2024-08-20,709,90,619,40256,3.390956779733325e+09,19.158576388888886
2024-08-21,50,7,43,40299,3.3578319202633276e+09,19.216145833333304
2024-08-22,160,80,80,40379,3.388775810186671e+09,20.261979166666627
2024-08-23,187,23,164,40543,3.4840191437988796e+09,21.57347222222228
2024-08-25,10,0,10,40553,3.5884226381899967e+09,25.61194444444447
2024-08-26,80,8,72,40625,3.5452041354166856e+09,24.12579861111109
2024-08-27,403,617,-214,40411,3.393423114557777e+09,22.53670138888899
2024-08-28,815,20,795,41206,3.291304205908898e+09,20.72409722222215
2024-08-29,1067,0,1067,42273,3.444939732850006e+09,20.689166666666644
2024-08-30,851,5,846,43119,3.4673187087299967e+09,19.792430555555594
2024-08-31,4,5,-1,43118,3.478688712028877e+09,19.623124999999977
2024-09-01,174,1,173,43291,3.4453194299199986e+09,19.244999999999994
<nil>,0,0,0,43291,4.764919155199995e+09,<nil>
<nil>,0,0,0,43291,3.6872267961566625e+09,<nil>
<nil>,0,0,0,43291,1.6788217572255547e+09,<nil>
<nil>,0,0,0,43291,2.576368961507776e+09,<nil>
<nil>,0,0,0,43291,6.469853033502225e+09,<nil>
<nil>,0,0,0,43291,1.4776959560222242e+09,<nil>
<nil>,0,0,0,43291,4.171139751098887e+09,<nil>
<nil>,0,0,0,43291,4.239338901364457e+09,<nil>
<nil>,0,0,0,43291,5.536263955271103e+09,<nil>
<nil>,0,0,0,43291,2.2769413245822215e+09,<nil>
<nil>,0,0,0,43291,1.6703189719155557e+09,<nil>
<nil>,0,0,0,43291,2.514824359458889e+09,<nil>
<nil>,0,0,0,43291,2.2208326290999966e+09,<nil>
<nil>,0,0,0,43291,2.596906308110003e+09,<nil>
<nil>,0,0,0,43291,4.081931719038888e+09,<nil>
<nil>,0,0,0,43291,4.8192705246889e+09,<nil>
<nil>,0,0,0,43291,3.96882378410334e+09,<nil>
<nil>,0,0,0,43291,2.124698277545556e+09,<nil>
<nil>,0,0,0,43291,2.341966955941112e+09,<nil>
<nil>,0,0,0,43291,2.3321125294088902e+09,<nil>
<nil>,0,0,0,43291,3.6036637180922165e+09,<nil>
<nil>,0,0,0,43291,2.016526478632225e+09,<nil>
<nil>,0,0,0,43291,1.8533590439477766e+09,<nil>
<nil>,0,0,0,43291,2.129471928014444e+09,<nil>
<nil>,0,0,0,43291,5.577913889663331e+09,<nil>
<nil>,0,0,0,43291,2.6393389918833337e+09,<nil>
<nil>,0,0,0,43291,3.9148587627388797e+09,<nil>
<nil>,0,0,0,43291,2.0561450550011132e+09,<nil>
<nil>,0,0,0,43291,2.571958426326667e+09,<nil>
<nil>,0,0,0,43291,2.5205819662566657e+09,<nil>
<nil>,0,0,0,43291,2.2914218754755554e+09,<nil>
<nil>,0,0,0,43291,2.642747917627776e+09,<nil>
<nil>,0,0,0,43291,3.665578217685555e+09,<nil>
<nil>,0,0,0,43291,4.462213908563328e+09,<nil>
<nil>,0,0,0,43291,2.3962467990777807e+09,<nil>
<nil>,0,0,0,43291,2.348310193766667e+09,<nil>
<nil>,0,0,0,43291,2.4837906288955564e+09,<nil>
<nil>,0,0,0,43291,4.015475320130007e+09,<nil>
<nil>,0,0,0,43291,2.546011965476661e+09,<nil>
<nil>,0,0,0,43291,1.4511391401733353e+09,<nil>
<nil>,0,0,0,43291,1.7761068797622216e+09,<nil>
<nil>,0,0,0,43291,4.83934605252333e+09,<nil>
<nil>,0,0,0,43291,2.447854529290001e+09,<nil>
<nil>,0,0,0,43291,2.6644517642755527e+09,<nil>
<nil>,0,0,0,43291,2.4519639034144444e+09,<nil>
<nil>,0,0,0,43291,6.042054594276638e+09,<nil>
<nil>,0,0,0,43291,2.6800238255822225e+09,<nil>
<nil>,0,0,0,43291,2.566014860633332e+09,<nil>
<nil>,0,0,0,43291,2.8923484793733344e+09,<nil>
<nil>,0,0,0,43291,4.7551988345655365e+09,<nil>
<nil>,0,0,0,43291,1.684668976393332e+09,<nil>
<nil>,0,0,0,43291,1.7746757274033327e+09,<nil>
<nil>,0,0,0,43291,2.5906328168955536e+09,<nil>
<nil>,0,0,0,43291,3.851434128762225e+09,<nil>
<nil>,0,0,0,43291,5.432010809576676e+09,<nil>
<nil>,0,0,0,43291,5.183427249623326e+09,<nil>
<nil>,0,0,0,43291,2.1411172070144515e+09,<nil>
<nil>,0,0,0,43291,2.159963943864443e+09,<nil>
<nil>,0,0,0,43291,2.31741792857111e+09,<nil>
<nil>,0,0,0,43291,2.635265789794442e+09,<nil>
<nil>,0,0,0,43291,4.117448809865551e+09,<nil>
<nil>,0,0,0,43291,1.5612099709533296e+09,<nil>
<nil>,0,0,0,43291,1.9250463905888913e+09,<nil>
<nil>,0,0,0,43291,2.5815488739611106e+09,<nil>
<nil>,0,0,0,43291,4.2228481569366727e+09,<nil>
<nil>,0,0,0,43291,2.5806457274988885e+09,<nil>
<nil>,0,0,0,43291,1.7200517689177785e+09,<nil>
<nil>,0,0,0,43291,2.4175238926677737e+09,<nil>
<nil>,0,0,0,43291,4.286837401755548e+09,<nil>
<nil>,0,0,0,43291,5.676699863068895e+09,<nil>
<nil>,0,0,0,43291,2.5433640474111114e+09,<nil>
<nil>,0,0,0,43291,2.565766755102223e+09,<nil>
<nil>,0,0,0,43291,5.570510166641114e+09,<nil>
<nil>,0,0,0,43291,2.3173893084100037e+09,<nil>
<nil>,0,0,0,43291,4.259632808243313e+09,<nil>
<nil>,0,0,0,43291,2.5637350122700014e+09,<nil>
<nil>,0,0,0,43291,1.7748499015266669e+09,<nil>
<nil>,0,0,0,43291,2.491725821094446e+09,<nil>
<nil>,0,0,0,43291,1.8342662699144435e+09,<nil>
<nil>,0,0,0,43291,2.2696012393300014e+09,<nil>
<nil>,0,0,0,43291,6.642498840232227e+09,<nil>
<nil>,0,0,0,43291,4.0736146040177784e+09,<nil>
<nil>,0,0,0,43291,2.773610213180011e+09,<nil>
<nil>,0,0,0,43291,3.8216958573233356e+09,<nil>
<nil>,0,0,0,43291,2.2572735498666644e+09,<nil>
<nil>,0,0,0,43291,1.8257835908688886e+09,<nil>
<nil>,0,0,0,43291,1.7941218521988916e+09,<nil>
<nil>,0,0,0,43291,1.484886350616666e+09,<nil>
<nil>,0,0,0,43291,3.5862870474000015e+09,<nil>
<nil>,0,0,0,43291,2.1315810655344448e+09,<nil>
<nil>,0,0,0,43291,2.6798033300888886e+09,<nil>
<nil>,0,0,0,43291,2.515101325656666e+09,<nil>
<nil>,0,0,0,43291,3.183894027726668e+09,<nil>
<nil>,0,0,0,43291,1.753152067517778e+09,<nil>
<nil>,0,0,0,43291,2.2926273855222254e+09,<nil>
<nil>,0,0,0,43291,2.5656927755933313e+09,<nil>
<nil>,0,0,0,43291,5.670827390817781e+09,<nil>
<nil>,0,0,0,43291,4.661290891039995e+09,<nil>
<nil>,0,0,0,43291,2.589512926826664e+09,<nil>
<nil>,0,0,0,43291,4.317562082680008e+09,<nil>
<nil>,0,0,0,43291,2.4344891545566807e+09,<nil>
<nil>,0,0,0,43291,2.2996564970911093e+09,<nil>
<nil>,0,0,0,43291,3.9300931542455564e+09,<nil>
<nil>,0,0,0,43291,1.8231944042600055e+09,<nil>
<nil>,0,0,0,43291,2.353292458754446e+09,<nil>
<nil>,0,0,0,43291,2.0682269958877738e+09,<nil>
<nil>,0,0,0,43291,2.3193058009799976e+09,<nil>
<nil>,0,0,0,43291,2.828660203206664e+09,<nil>
<nil>,0,0,0,43291,2.192231516028883e+09,<nil>
<nil>,0,0,0,43291,1.8871906237400043e+09,<nil>
<nil>,0,0,0,43291,4.57511553783333e+09,<nil>
<nil>,0,0,0,43291,1.8261905743699987e+09,<nil>
<nil>,0,0,0,43291,2.289566423215556e+09,<nil>
<nil>,0,0,0,43291,2.259636757455551e+09,<nil>
<nil>,0,0,0,43291,2.415624764598881e+09,<nil>
<nil>,0,0,0,43291,1.689317515872221e+09,<nil>
<nil>,0,0,0,43291,2.6374233170322227e+09,<nil>
<nil>,0,0,0,43291,3.5212408287655544e+09,<nil>
<nil>,0,0,0,43291,3.0112440843011e+09,<nil>
<nil>,0,0,0,43291,2.625323338228888e+09,<nil>
<nil>,0,0,0,43291,3.868719599747766e+09,<nil>
<nil>,0,0,0,43291,2.566652007951119e+09,<nil>
<nil>,0,0,0,43291,2.2604589978488894e+09,<nil>
<nil>,0,0,0,43291,2.4960210579122195e+09,<nil>
<nil>,0,0,0,43291,2.825919353794452e+09,<nil>
<nil>,0,0,0,43291,2.1048735489044473e+09,<nil>
<nil>,0,0,0,43291,2.649372017841121e+09,<nil>
<nil>,0,0,0,43291,1.8420202652277827e+09,<nil>
<nil>,0,0,0,43291,2.115365363260005e+09,<nil>
<nil>,0,0,0,43291,2.1656802799088926e+09,<nil>
<nil>,0,0,0,43291,2.581602410497777e+09,<nil>
<nil>,0,0,0,43291,6.389854343973308e+09,<nil>
<nil>,0,0,0,43291,2.0760172594388895e+09,<nil>
<nil>,0,0,0,43291,2.501353787595552e+09,<nil>
<nil>,0,0,0,43291,2.1873924961499996e+09,<nil>
<nil>,0,0,0,43291,2.265461657707781e+09,<nil>
<nil>,0,0,0,43291,3.9269338251666594e+09,<nil>
<nil>,0,0,0,43291,5.787468256162207e+09,<nil>
<nil>,0,0,0,43291,4.833130571248905e+09,<nil>
<nil>,0,0,0,43291,2.269102478908884e+09,<nil>
<nil>,0,0,0,43291,1.6562020173211064e+09,<nil>
<nil>,0,0,0,43291,4.611679693646677e+09,<nil>
<nil>,0,0,0,43291,3.5458926001088834e+09,<nil>
<nil>,0,0,0,43291,2.633196479994445e+09,<nil>
<nil>,0,0,0,43291,2.1712203253811164e+09,<nil>
<nil>,0,0,0,43291,2.10990612765445e+09,<nil>
<nil>,0,0,0,43291,2.1461797527566664e+09,<nil>
<nil>,0,0,0,43291,2.5910912204844456e+09,<nil>
<nil>,0,0,0,43291,5.714512290816658e+09,<nil>
<nil>,0,0,0,43291,6.288545082481093e+09,<nil>
<nil>,0,0,0,43291,5.238119030675533e+09,<nil>
<nil>,0,0,0,43291,2.191697064583334e+09,<nil>
<nil>,0,0,0,43291,2.555032992157779e+09,<nil>
<nil>,0,0,0,43291,2.197897297805558e+09,<nil>
<nil>,0,0,0,43291,2.643724658789999e+09,<nil>
<nil>,0,0,0,43291,1.704500583493331e+09,<nil>
<nil>,0,0,0,43291,1.6896440262144418e+09,<nil>
<nil>,0,0,0,43291,2.258277901066667e+09,<nil>
<nil>,0,0,0,43291,5.069639213077773e+09,<nil>
<nil>,0,0,0,43291,1.7209913760222235e+09,<nil>
<nil>,0,0,0,43291,4.0406690947933426e+09,<nil>
<nil>,0,0,0,43291,2.1288760033488896e+09,<nil>
<nil>,0,0,0,43291,4.516794287442223e+09,<nil>
<nil>,0,0,0,43291,2.3104437965722275e+09,<nil>
<nil>,0,0,0,43291,3.864667081136667e+09,<nil>
<nil>,0,0,0,43291,4.106937177852215e+09,<nil>
<nil>,0,0,0,43291,3.3256381414433417e+09,<nil>
<nil>,0,0,0,43291,2.167785088328889e+09,<nil>
<nil>,0,0,0,43291,3.2693115479277916e+09,<nil>
<nil>,0,0,0,43291,2.633953831988892e+09,<nil>
<nil>,0,0,0,43291,2.639655978205559e+09,<nil>
<nil>,0,0,0,43291,4.194476245659994e+09,<nil>
<nil>,0,0,0,43291,2.1524097124655523e+09,<nil>
<nil>,0,0,0,43291,2.5308663205200005e+09,<nil>
<nil>,0,0,0,43291,1.8018551640344443e+09,<nil>
<nil>,0,0,0,43291,1.7876657691666615e+09,<nil>
<nil>,0,0,0,43291,2.1859608146788907e+09,<nil>
<nil>,0,0,0,43291,1.742865837311108e+09,<nil>
<nil>,0,0,0,43291,2.5656582389955587e+09,<nil>
<nil>,0,0,0,43291,2.1625268191655507e+09,<nil>
<nil>,0,0,0,43291,2.664273116748897e+09,<nil>
<nil>,0,0,0,43291,4.1766625763733335e+09,<nil>
<nil>,0,0,0,43291,2.2649968085700006e+09,<nil>
<nil>,0,0,0,43291,2.289164682735565e+09,<nil>
<nil>,0,0,0,43291,4.619876315384475e+09,<nil>
<nil>,0,0,0,43291,1.7645881066844425e+09,<nil>
<nil>,0,0,0,43291,2.547766790212222e+09,<nil>
<nil>,0,0,0,43291,1.734885333865554e+09,<nil>
<nil>,0,0,0,43291,1.7644860361266696e+09,<nil>
<nil>,0,0,0,43291,4.1410674655444465e+09,<nil>
<nil>,0,0,0,43291,1.9447069501377778e+09,<nil>
<nil>,0,0,0,43291,5.765691873038893e+09,<nil>
<nil>,0,0,0,43291,2.7306328805255513e+09,<nil>
<nil>,0,0,0,43291,2.1760990767777734e+09,<nil>
<nil>,0,0,0,43291,2.172526174345554e+09,<nil>
<nil>,0,0,0,43291,2.60499874284111e+09,<nil>
<nil>,0,0,0,43291,2.2631561714522257e+09,<nil>
<nil>,0,0,0,43291,2.510688433521113e+09,<nil>
<nil>,0,0,0,43291,1.6622027271344447e+09,<nil>
<nil>,0,0,0,43291,2.3023561719522257e+09,<nil>
<nil>,0,0,0,43291,1.8202037657777865e+09,<nil>
<nil>,0,0,0,43291,2.192062055814453e+09,<nil>
<nil>,0,0,0,43291,2.4755184884133344e+09,<nil>
<nil>,0,0,0,43291,2.600660118821112e+09,<nil>
<nil>,0,0,0,43291,2.2265870131233273e+09,<nil>
<nil>,0,0,0,43291,2.1357035712622197e+09,<nil>
<nil>,0,0,0,43291,2.4986953353866653e+09,<nil>
<nil>,0,0,0,43291,2.2502875368933306e+09,<nil>
<nil>,0,0,0,43291,2.3973676511688886e+09,<nil>
<nil>,0,0,0,43291,3.847937755197774e+09,<nil>
<nil>,0,0,0,43291,5.25992951748668e+09,<nil>
<nil>,0,0,0,43291,2.567413929551114e+09,<nil>
<nil>,0,0,0,43291,2.0015040687222145e+09,<nil>
<nil>,0,0,0,43291,2.1872112511633325e+09,<nil>
<nil>,0,0,0,43291,2.1796457160033336e+09,<nil>
<nil>,0,0,0,43291,6.096712367843337e+09,<nil>
<nil>,0,0,0,43291,2.446887071642217e+09,<nil>
<nil>,0,0,0,43291,2.25750953391778e+09,<nil>
<nil>,0,0,0,43291,2.261413516297778e+09,<nil>
<nil>,0,0,0,43291,3.363735423971111e+09,<nil>
<nil>,0,0,0,43291,2.7462681466922164e+09,<nil>
<nil>,0,0,0,43291,2.563359919805552e+09,<nil>
<nil>,0,0,0,43291,1.8438900997200055e+09,<nil>
<nil>,0,0,0,43291,3.7496519371455584e+09,<nil>
<nil>,0,0,0,43291,1.778231072929999e+09,<nil>
<nil>,0,0,0,43291,3.282565520487775e+09,<nil>
<nil>,0,0,0,43291,4.102132935076666e+09,<nil>
<nil>,0,0,0,43291,5.942311985973331e+09,<nil>
<nil>,0,0,0,43291,1.6608811972077794e+09,<nil>
<nil>,0,0,0,43291,4.339356070809991e+09,<nil>
<nil>,0,0,0,43291,1.6757619493455555e+09,<nil>
<nil>,0,0,0,43291,5.138434769019985e+09,<nil>
<nil>,0,0,0,43291,2.558804359774446e+09,<nil>
<nil>,0,0,0,43291,2.9058282866499968e+09,<nil>
<nil>,0,0,0,43291,1.63971127289333e+09,<nil>
<nil>,0,0,0,43291,1.656150260525553e+09,<nil>
<nil>,0,0,0,43291,2.1897304506555543e+09,<nil>
<nil>,0,0,0,43291,5.547684553981139e+09,<nil>
<nil>,0,0,0,43291,1.7049744275388856e+09,<nil>
<nil>,0,0,0,43291,3.757498430895566e+09,<nil>
<nil>,0,0,0,43291,2.1893742138266673e+09,<nil>
<nil>,0,0,0,43291,1.6849423831088781e+09,<nil>
<nil>,0,0,0,43291,2.444360608882227e+09,<nil>
<nil>,0,0,0,43291,1.6714310215033383e+09,<nil>
<nil>,0,0,0,43291,4.362753749984448e+09,<nil>
<nil>,0,0,0,43291,1.7531182043355546e+09,<nil>
<nil>,0,0,0,43291,2.27737928519889e+09,<nil>
<nil>,0,0,0,43291,2.459605342127773e+09,<nil>
<nil>,0,0,0,43291,2.88620553457445e+09,<nil>
<nil>,0,0,0,43291,2.0663385462655556e+09,<nil>
<nil>,0,0,0,43291,1.633495887821112e+09,<nil>
<nil>,0,0,0,43291,2.649270043485559e+09,<nil>
<nil>,0,0,0,43291,5.98402045941777e+09,<nil>
<nil>,0,0,0,43291,4.218522375913341e+09,<nil>
<nil>,0,0,0,43291,3.693828144544453e+09,<nil>
<nil>,0,0,0,43291,2.2415666130444446e+09,<nil>
<nil>,0,0,0,43291,2.319721538883315e+09,<nil>
<nil>,0,0,0,43291,2.599958179306664e+09,<nil>
<nil>,0,0,0,43291,5.731946153730005e+09,<nil>
<nil>,0,0,0,43291,4.753972208131132e+09,<nil>
<nil>,0,0,0,43291,4.39542407275221e+09,<nil>
<nil>,0,0,0,43291,4.149615321595549e+09,<nil>
<nil>,0,0,0,43291,2.16787768296778e+09,<nil>
<nil>,0,0,0,43291,1.6867335241833315e+09,<nil>
<nil>,0,0,0,43291,6.564273398164462e+09,<nil>
<nil>,0,0,0,43291,2.5268046145966716e+09,<nil>
<nil>,0,0,0,43291,2.655917905647783e+09,<nil>
<nil>,0,0,0,43291,2.606825767344443e+09,<nil>
<nil>,0,0,0,43291,2.5474334976133347e+09,<nil>
<nil>,0,0,0,43291,2.1442760069811132e+09,<nil>
<nil>,0,0,0,43291,2.6146470080111113e+09,<nil>
<nil>,0,0,0,43291,2.909085357186665e+09,<nil>
<nil>,0,0,0,43291,5.627387950788877e+09,<nil>
<nil>,0,0,0,43291,6.350432308744444e+09,<nil>
<nil>,0,0,0,43291,3.5483251213988914e+09,<nil>
<nil>,0,0,0,43291,2.299071106568888e+09,<nil>
<nil>,0,0,0,43291,2.4073229938322263e+09,<nil>
<nil>,0,0,0,43291,3.625343610386673e+09,<nil>
<nil>,0,0,0,43291,3.173344251532226e+09,<nil>
<nil>,0,0,0,43291,2.2889232632588925e+09,<nil>
<nil>,0,0,0,43291,2.2292524880944457e+09,<nil>
<nil>,0,0,0,43291,1.7103772405411103e+09,<nil>
<nil>,0,0,0,43291,1.6589752387811105e+09,<nil>
<nil>,0,0,0,43291,6.277258060556639e+09,<nil>
<nil>,0,0,0,43291,5.2523695620555525e+09,<nil>
<nil>,0,0,0,43291,4.82850314815777e+09,<nil>
<nil>,0,0,0,43291,2.8238536515777836e+09,<nil>
<nil>,0,0,0,43291,2.3313342053299956e+09,<nil>
<nil>,0,0,0,43291,2.290814647048888e+09,<nil>
<nil>,0,0,0,43291,1.7441806811833363e+09,<nil>
<nil>,0,0,0,43291,4.389542653694454e+09,<nil>
<nil>,0,0,0,43291,2.0178084213444445e+09,<nil>
<nil>,0,0,0,43291,3.092064725616661e+09,<nil>
<nil>,0,0,0,43291,2.311204515644444e+09,<nil>
<nil>,0,0,0,43291,2.5161866310266685e+09,<nil>
<nil>,0,0,0,43291,2.281965100828886e+09,<nil>
<nil>,0,0,0,43291,1.815868701239997e+09,<nil>
<nil>,0,0,0,43291,5.796720023873335e+09,<nil>
<nil>,0,0,0,43291,1.510394754647783e+09,<nil>
<nil>,0,0,0,43291,1.958124899385556e+09,<nil>
<nil>,0,0,0,43291,1.6757742151288912e+09,<nil>
<nil>,0,0,0,43291,1.7866168282366724e+09,<nil>
<nil>,0,0,0,43291,2.5223337125211086e+09,<nil>
<nil>,0,0,0,43291,3.6543848486244407e+09,<nil>
<nil>,0,0,0,43291,4.631286428052233e+09,<nil>
<nil>,0,0,0,43291,2.8621189031855574e+09,<nil>
<nil>,0,0,0,43291,2.571432248272221e+09,<nil>
<nil>,0,0,0,43291,2.2577914064288893e+09,<nil>
<nil>,0,0,0,43291,1.5862501587688866e+09,<nil>
<nil>,0,0,0,43291,2.5808299066533303e+09,<nil>
<nil>,0,0,0,43291,5.590007038108884e+09,<nil>
<nil>,0,0,0,43291,2.6350796865955467e+09,<nil>
<nil>,0,0,0,43291,2.547970835125556e+09,<nil>
<nil>,0,0,0,43291,2.6421156766233306e+09,<nil>
<nil>,0,0,0,43291,1.8102250940755572e+09,<nil>
<nil>,0,0,0,43291,3.187419646766669e+09,<nil>
<nil>,0,0,0,43291,2.1562329811811094e+09,<nil>
<nil>,0,0,0,43291,3.7969064687011137e+09,<nil>
<nil>,0,0,0,43291,4.484146860803333e+09,<nil>
<nil>,0,0,0,43291,1.7529638959711142e+09,<nil>
<nil>,0,0,0,43291,4.022862640673326e+09,<nil>
<nil>,0,0,0,43291,1.8629060081777763e+09,<nil>
<nil>,0,0,0,43291,2.5886267600566688e+09,<nil>
<nil>,0,0,0,43291,1.682527899735556e+09,<nil>
<nil>,0,0,0,43291,1.727249619184446e+09,<nil>
<nil>,0,0,0,43291,4.610974242751109e+09,<nil>
<nil>,0,0,0,43291,3.835003655026661e+09,<nil>
<nil>,0,0,0,43291,5.6395123168555765e+09,<nil>
<nil>,0,0,0,43291,2.233374705215552e+09,<nil>
<nil>,0,0,0,43291,2.7309699250111065e+09,<nil>
<nil>,0,0,0,43291,2.262464717979993e+09,<nil>
<nil>,0,0,0,43291,2.210222486011107e+09,<nil>
<nil>,0,0,0,43291,2.264598868077776e+09,<nil>
<nil>,0,0,0,43291,4.514738349751112e+09,<nil>
<nil>,0,0,0,43291,1.7109167907044492e+09,<nil>
<nil>,0,0,0,43291,2.2770323318844533e+09,<nil>
<nil>,0,0,0,43291,2.247576029158901e+09,<nil>
<nil>,0,0,0,43291,4.836063969408889e+09,<nil>
<nil>,0,0,0,43291,2.787292237527777e+09,<nil>
<nil>,0,0,0,43291,2.0732646733555565e+09,<nil>
<nil>,0,0,0,43291,2.378271269552223e+09,<nil>
<nil>,0,0,0,43291,1.9467440321933396e+09,<nil>
<nil>,0,0,0,43291,3.137485642816672e+09,<nil>
<nil>,0,0,0,43291,2.3622199768755593e+09,<nil>
<nil>,0,0,0,43291,2.306706388339994e+09,<nil>
<nil>,0,0,0,43291,2.2668693848255534e+09,<nil>
<nil>,0,0,0,43291,3.360334819718885e+09,<nil>
<nil>,0,0,0,43291,5.96992846929999e+09,<nil>
<nil>,0,0,0,43291,3.953719506102234e+09,<nil>
<nil>,0,0,0,43291,2.5587515447544465e+09,<nil>
<nil>,0,0,0,43291,3.944615745509981e+09,<nil>
<nil>,0,0,0,43291,2.60412426464111e+09,<nil>
<nil>,0,0,0,43291,2.57936046581e+09,<nil>
<nil>,0,0,0,43291,2.350061843828886e+09,<nil>
<nil>,0,0,0,43291,2.616556670223329e+09,<nil>
<nil>,0,0,0,43291,4.459918042529998e+09,<nil>
<nil>,0,0,0,43291,2.47482395647e+09,<nil>
<nil>,0,0,0,43291,5.16940327447668e+09,<nil>
<nil>,0,0,0,43291,6.186424355244456e+09,<nil>
<nil>,0,0,0,43291,2.262337490541105e+09,<nil>
<nil>,0,0,0,43291,2.235967643711106e+09,<nil>
<nil>,0,0,0,43291,1.7815655862555583e+09,<nil>
<nil>,0,0,0,43291,2.75288921653555e+09,<nil>
<nil>,0,0,0,43291,4.256860645007781e+09,<nil>
<nil>,0,0,0,43291,2.3217550133555603e+09,<nil>
<nil>,0,0,0,43291,3.580284990755548e+09,<nil>
<nil>,0,0,0,43291,2.3297374889466567e+09,<nil>
<nil>,0,0,0,43291,2.5084283066133337e+09,<nil>
<nil>,0,0,0,43291,1.583721146650005e+09,<nil>
<nil>,0,0,0,43291,2.349900031691113e+09,<nil>
<nil>,0,0,0,43291,2.544798855454444e+09,<nil>
<nil>,0,0,0,43291,1.8253337492777808e+09,<nil>
<nil>,0,0,0,43291,2.1514672673955564e+09,<nil>
<nil>,0,0,0,43291,2.4087056121699996e+09,<nil>
<nil>,0,0,0,43291,2.207966159091121e+09,<nil>
<nil>,0,0,0,43291,1.6818386108133326e+09,<nil>
<nil>,0,0,0,43291,2.413888218285559e+09,<nil>
<nil>,0,0,0,43291,2.214873190040003e+09,<nil>
<nil>,0,0,0,43291,4.011685481686661e+09,<nil>
<nil>,0,0,0,43291,2.61964331852334e+09,<nil>
<nil>,0,0,0,43291,4.2749868272133265e+09,<nil>
<nil>,0,0,0,43291,5.351331104516693e+09,<nil>
<nil>,0,0,0,43291,1.8222572022111151e+09,<nil>
<nil>,0,0,0,43291,2.1777218639633336e+09,<nil>
<nil>,0,0,0,43291,4.386386162581129e+09,<nil>
<nil>,0,0,0,43291,2.273108147037779e+09,<nil>
<nil>,0,0,0,43291,1.4732376083366635e+09,<nil>
<nil>,0,0,0,43291,3.5570002529899936e+09,<nil>
<nil>,0,0,0,43291,2.5247443478055553e+09,<nil>
<nil>,0,0,0,43291,2.1602886263644433e+09,<nil>
<nil>,0,0,0,43291,3.7465704837655563e+09,<nil>
<nil>,0,0,0,43291,2.5543477918300014e+09,<nil>
<nil>,0,0,0,43291,6.571862791475561e+09,<nil>
<nil>,0,0,0,43291,2.49292300964889e+09,<nil>
<nil>,0,0,0,43291,5.7721335738388815e+09,<nil>
<nil>,0,0,0,43291,1.703080590592221e+09,<nil>
<nil>,0,0,0,43291,2.677600395402219e+09,<nil>
<nil>,0,0,0,43291,1.5070853501022186e+09,<nil>
<nil>,0,0,0,43291,2.516986360099999e+09,<nil>
<nil>,0,0,0,43291,2.275900993751115e+09,<nil>
<nil>,0,0,0,43291,6.034263994017783e+09,<nil>
<nil>,0,0,0,43291,2.5767840740966697e+09,<nil>
<nil>,0,0,0,43291,3.9151005670244412e+09,<nil>
<nil>,0,0,0,43291,5.914863519827784e+09,<nil>
<nil>,0,0,0,43291,4.2309224094477854e+09,<nil>
<nil>,0,0,0,43291,2.269594360871111e+09,<nil>
<nil>,0,0,0,43291,5.2261704260689125e+09,<nil>
<nil>,0,0,0,43291,2.245480937163333e+09,<nil>
<nil>,0,0,0,43291,2.6330050856733394e+09,<nil>
<nil>,0,0,0,43291,4.2854492036888747e+09,<nil>
<nil>,0,0,0,43291,2.3735049785533323e+09,<nil>
<nil>,0,0,0,43291,2.509192104156665e+09,<nil>
<nil>,0,0,0,43291,4.324425053011109e+09,<nil>
<nil>,0,0,0,43291,2.635840694274446e+09,<nil>
<nil>,0,0,0,43291,1.8915467565644429e+09,<nil>
<nil>,0,0,0,43291,2.2622424908466663e+09,<nil>
<nil>,0,0,0,43291,2.7131362456622195e+09,<nil>
<nil>,0,0,0,43291,2.2605006053099947e+09,<nil>
<nil>,0,0,0,43291,2.170343682631111e+09,<nil>
<nil>,0,0,0,43291,1.8752234521044493e+09,<nil>
<nil>,0,0,0,43291,3.701664152252214e+09,<nil>
<nil>,0,0,0,43291,3.490774835616657e+09,<nil>
<nil>,0,0,0,43291,3.426632484961111e+09,<nil>
<nil>,0,0,0,43291,3.8525043303833294e+09,<nil>
<nil>,0,0,0,43291,2.61953566823667e+09,<nil>
<nil>,0,0,0,43291,1.61103247652778e+09,<nil>
<nil>,0,0,0,43291,2.5849498630222135e+09,<nil>
<nil>,0,0,0,43291,2.3484991830322227e+09,<nil>
<nil>,0,0,0,43291,2.561327647861111e+09,<nil>
<nil>,0,0,0,43291,1.6495479982166708e+09,<nil>
<nil>,0,0,0,43291,3.903518252378884e+09,<nil>
<nil>,0,0,0,43291,2.6310162490322194e+09,<nil>
<nil>,0,0,0,43291,4.3739088305611e+09,<nil>
<nil>,0,0,0,43291,1.6769325860866632e+09,<nil>
<nil>,0,0,0,43291,3.984401232734442e+09,<nil>
<nil>,0,0,0,43291,1.6584554100733306e+09,<nil>
<nil>,0,0,0,43291,2.2902744715711145e+09,<nil>
<nil>,0,0,0,43291,4.516124431368883e+09,<nil>
<nil>,0,0,0,43291,2.598666087260004e+09,<nil>
<nil>,0,0,0,43291,2.4874736828722196e+09,<nil>
<nil>,0,0,0,43291,4.332369769229993e+09,<nil>
<nil>,0,0,0,43291,2.2161861098677745e+09,<nil>
<nil>,0,0,0,43291,4.350382432813337e+09,<nil>
<nil>,0,0,0,43291,1.5547408044188836e+09,<nil>
<nil>,0,0,0,43291,2.1635318437811117e+09,<nil>
<nil>,0,0,0,43291,2.5846820360355544e+09,<nil>
<nil>,0,0,0,43291,1.7047294485799952e+09,<nil>
<nil>,0,0,0,43291,1.6839574647577765e+09,<nil>
<nil>,0,0,0,43291,6.335966476791081e+09,<nil>
<nil>,0,0,0,43291,3.1069451410466614e+09,<nil>
<nil>,0,0,0,43291,2.202244339519997e+09,<nil>
<nil>,0,0,0,43291,2.209306015541105e+09,<nil>
<nil>,0,0,0,43291,3.9673649736055713e+09,<nil>
<nil>,0,0,0,43291,2.1231487002511122e+09,<nil>
<nil>,0,0,0,43291,2.417429566388894e+09,<nil>
<nil>,0,0,0,43291,2.486652356399999e+09,<nil>
<nil>,0,0,0,43291,2.589070107997773e+09,<nil>
<nil>,0,0,0,43291,2.400869652563328e+09,<nil>
<nil>,0,0,0,43291,3.667187632762218e+09,<nil>
<nil>,0,0,0,43291,2.557427561671109e+09,<nil>
<nil>,0,0,0,43291,2.30980650495111e+09,<nil>
<nil>,0,0,0,43291,3.9666197430911098e+09,<nil>
<nil>,0,0,0,43291,1.9696439129688847e+09,<nil>
<nil>,0,0,0,43291,6.181673649005572e+09,<nil>
<nil>,0,0,0,43291,2.706290303124438e+09,<nil>
<nil>,0,0,0,43291,2.8671782742544394e+09,<nil>
<nil>,0,0,0,43291,2.2141803897366595e+09,<nil>
<nil>,0,0,0,43291,1.8060176898866653e+09,<nil>
<nil>,0,0,0,43291,2.595280586756674e+09,<nil>
<nil>,0,0,0,43291,5.572485583072217e+09,<nil>
<nil>,0,0,0,43291,1.4610056400844486e+09,<nil>
<nil>,0,0,0,43291,2.5768282790177774e+09,<nil>
<nil>,0,0,0,43291,2.527854613751111e+09,<nil>
<nil>,0,0,0,43291,1.5385615146855493e+09,<nil>
<nil>,0,0,0,43291,2.6000148905166707e+09,<nil>
<nil>,0,0,0,43291,2.9108878501233344e+09,<nil>
<nil>,0,0,0,43291,4.295235182339999e+09,<nil>
<nil>,0,0,0,43291,1.7856167580355592e+09,<nil>
<nil>,0,0,0,43291,4.538037758355565e+09,<nil>
<nil>,0,0,0,43291,5.661030926124453e+09,<nil>
<nil>,0,0,0,43291,2.6387016040600047e+09,<nil>
<nil>,0,0,0,43291,6.139708411830009e+09,<nil>
<nil>,0,0,0,43291,2.1792351249188876e+09,<nil>
<nil>,0,0,0,43291,2.634013717872224e+09,<nil>
<nil>,0,0,0,43291,1.6588352645477777e+09,<nil>
<nil>,0,0,0,43291,4.695087934234443e+09,<nil>
<nil>,0,0,0,43291,3.612104260564447e+09,<nil>
<nil>,0,0,0,43291,2.366901513716666e+09,<nil>
<nil>,0,0,0,43291,2.196983088087772e+09,<nil>
<nil>,0,0,0,43291,1.584903375758888e+09,<nil>
<nil>,0,0,0,43291,1.6873805803299987e+09,<nil>
<nil>,0,0,0,43291,2.3166269539000006e+09,<nil>
<nil>,0,0,0,43291,2.2729902993155575e+09,<nil>
<nil>,0,0,0,43291,4.325353644961112e+09,<nil>
<nil>,0,0,0,43291,2.636199528563338e+09,<nil>
<nil>,0,0,0,43291,4.1780897844411106e+09,<nil>
<nil>,0,0,0,43291,2.2575943842777743e+09,<nil>
<nil>,0,0,0,43291,2.3624892468955564e+09,<nil>
<nil>,0,0,0,43291,2.1118112202611022e+09,<nil>
<nil>,0,0,0,43291,3.584409516729992e+09,<nil>
<nil>,0,0,0,43291,2.2728950591155577e+09,<nil>
<nil>,0,0,0,43291,1.5570305616111076e+09,<nil>
<nil>,0,0,0,43291,2.1646690502499995e+09,<nil>
<nil>,0,0,0,43291,1.7627473252633348e+09,<nil>
<nil>,0,0,0,43291,2.486778862322232e+09,<nil>
<nil>,0,0,0,43291,4.267374489672228e+09,<nil>
<nil>,0,0,0,43291,4.369021228559997e+09,<nil>
<nil>,0,0,0,43291,6.04192053648001e+09,<nil>
<nil>,0,0,0,43291,2.664966446164447e+09,<nil>
<nil>,0,0,0,43291,1.8672352043799968e+09,<nil>
<nil>,0,0,0,43291,1.5086370438455591e+09,<nil>
<nil>,0,0,0,43291,2.7999529790844526e+09,<nil>
<nil>,0,0,0,43291,3.543558156984442e+09,<nil>
<nil>,0,0,0,43291,1.680251803258889e+09,<nil>
<nil>,0,0,0,43291,4.335263147265562e+09,<nil>
<nil>,0,0,0,43291,1.5774502528955636e+09,<nil>
<nil>,0,0,0,43291,2.1958837852944455e+09,<nil>
<nil>,0,0,0,43291,2.566294231886663e+09,<nil>
<nil>,0,0,0,43291,1.7777867629666665e+09,<nil>
<nil>,0,0,0,43291,2.400611493899998e+09,<nil>
<nil>,0,0,0,43291,1.845591676525553e+09,<nil>
<nil>,0,0,0,43291,3.722066286631116e+09,<nil>
<nil>,0,0,0,43291,1.6411664758077774e+09,<nil>
<nil>,0,0,0,43291,2.230293251835561e+09,<nil>
<nil>,0,0,0,43291,4.0867128251800156e+09,<nil>
<nil>,0,0,0,43291,4.2506648851888967e+09,<nil>
<nil>,0,0,0,43291,2.455063490913332e+09,<nil>
<nil>,0,0,0,43291,2.6249490634833307e+09,<nil>
<nil>,0,0,0,43291,2.0122784771055543e+09,<nil>
<nil>,0,0,0,43291,2.62402061583667e+09,<nil>
<nil>,0,0,0,43291,1.478349313414438e+09,<nil>
<nil>,0,0,0,43291,2.5602088160166674e+09,<nil>
<nil>,0,0,0,43291,1.8322810889577835e+09,<nil>
<nil>,0,0,0,43291,1.819324140758886e+09,<nil>
<nil>,0,0,0,43291,2.737101710352224e+09,<nil>
<nil>,0,0,0,43291,4.6327512992899885e+09,<nil>
<nil>,0,0,0,43291,5.47058770828336e+09,<nil>
<nil>,0,0,0,43291,2.7039410448577776e+09,<nil>
<nil>,0,0,0,43291,3.528945568541103e+09,<nil>
<nil>,0,0,0,43291,2.3920162101533337e+09,<nil>
<nil>,0,0,0,43291,2.5006783517933345e+09,<nil>
<nil>,0,0,0,43291,6.03479570369999e+09,<nil>
<nil>,0,0,0,43291,2.580552988556665e+09,<nil>
<nil>,0,0,0,43291,2.901069066514444e+09,<nil>
<nil>,0,0,0,43291,4.420593267747764e+09,<nil>
<nil>,0,0,0,43291,2.2855142894133286e+09,<nil>
<nil>,0,0,0,43291,1.79482985245333e+09,<nil>
<nil>,0,0,0,43291,2.37346471792333e+09,<nil>
<nil>,0,0,0,43291,2.5153748285744433e+09,<nil>
<nil>,0,0,0,43291,5.45110897093445e+09,<nil>
<nil>,0,0,0,43291,1.7583497773822215e+09,<nil>
<nil>,0,0,0,43291,2.161911798358888e+09,<nil>
<nil>,0,0,0,43291,2.4618994284200015e+09,<nil>
<nil>,0,0,0,43291,2.193640638078894e+09,<nil>
<nil>,0,0,0,43291,6.499741861418882e+09,<nil>
<nil>,0,0,0,43291,1.7659829908055532e+09,<nil>
<nil>,0,0,0,43291,2.32324355034e+09,<nil>
<nil>,0,0,0,43291,2.228299749386675e+09,<nil>
<nil>,0,0,0,43291,1.6533040215788822e+09,<nil>
<nil>,0,0,0,43291,2.875091628548885e+09,<nil>
<nil>,0,0,0,43291,4.010343941697778e+09,<nil>
<nil>,0,0,0,43291,2.2176973986777744e+09,<nil>
<nil>,0,0,0,43291,2.1104118627366664e+09,<nil>
<nil>,0,0,0,43291,4.959241487146665e+09,<nil>
<nil>,0,0,0,43291,6.248064197493338e+09,<nil>
<nil>,0,0,0,43291,2.1897241975111027e+09,<nil>
<nil>,0,0,0,43291,1.7387924909188893e+09,<nil>
<nil>,0,0,0,43291,2.332406715804444e+09,<nil>
<nil>,0,0,0,43291,4.0395213541810975e+09,<nil>
<nil>,0,0,0,43291,2.557961387802223e+09,<nil>
<nil>,0,0,0,43291,2.6505595380722246e+09,<nil>
<nil>,0,0,0,43291,2.6410766926233344e+09,<nil>
<nil>,0,0,0,43291,3.999690411406657e+09,<nil>
<nil>,0,0,0,43291,2.539977873492221e+09,<nil>
<nil>,0,0,0,43291,2.620058142505564e+09,<nil>
<nil>,0,0,0,43291,2.497799115484438e+09,<nil>
<nil>,0,0,0,43291,2.599792422877777e+09,<nil>
<nil>,0,0,0,43291,2.445331722214444e+09,<nil>
<nil>,0,0,0,43291,5.844312129026673e+09,<nil>
<nil>,0,0,0,43291,2.1082411557944434e+09,<nil>
<nil>,0,0,0,43291,2.498065499437779e+09,<nil>
<nil>,0,0,0,43291,2.2660357925700016e+09,<nil>
<nil>,0,0,0,43291,2.2656520900066657e+09,<nil>
<nil>,0,0,0,43291,1.8076082974288936e+09,<nil>
<nil>,0,0,0,43291,1.6252417852555535e+09,<nil>
<nil>,0,0,0,43291,2.401226418504451e+09,<nil>
<nil>,0,0,0,43291,2.3384334483188887e+09,<nil>
<nil>,0,0,0,43291,4.567400985431122e+09,<nil>
<nil>,0,0,0,43291,1.6897061728499992e+09,<nil>
<nil>,0,0,0,43291,2.203315695567778e+09,<nil>
<nil>,0,0,0,43291,6.288164169782247e+09,<nil>
<nil>,0,0,0,43291,2.21660381991666e+09,<nil>
<nil>,0,0,0,43291,3.416154427523331e+09,<nil>
<nil>,0,0,0,43291,2.274390041648889e+09,<nil>
<nil>,0,0,0,43291,2.243739773143341e+09,<nil>
<nil>,0,0,0,43291,3.710999519694437e+09,<nil>
<nil>,0,0,0,43291,2.7732018828477893e+09,<nil>
<nil>,0,0,0,43291,1.8338748711733336e+09,<nil>
<nil>,0,0,0,43291,2.287150496808891e+09,<nil>
<nil>,0,0,0,43291,2.4363754396288967e+09,<nil>
<nil>,0,0,0,43291,1.569670379184442e+09,<nil>
<nil>,0,0,0,43291,2.8579896152011094e+09,<nil>
<nil>,0,0,0,43291,2.4223087025944448e+09,<nil>
<nil>,0,0,0,43291,6.510170374712208e+09,<nil>
<nil>,0,0,0,43291,3.386620489604434e+09,<nil>
<nil>,0,0,0,43291,2.599471396062225e+09,<nil>
<nil>,0,0,0,43291,2.382780412011109e+09,<nil>
<nil>,0,0,0,43291,2.1587471781577773e+09,<nil>
<nil>,0,0,0,43291,2.023236006418884e+09,<nil>
<nil>,0,0,0,43291,4.070973323905564e+09,<nil>
<nil>,0,0,0,43291,2.481965480335561e+09,<nil>
<nil>,0,0,0,43291,5.652577203947751e+09,<nil>
<nil>,0,0,0,43291,2.729581871247771e+09,<nil>
<nil>,0,0,0,43291,1.8517784895377777e+09,<nil>
<nil>,0,0,0,43291,1.702959183387774e+09,<nil>
<nil>,0,0,0,43291,2.682488815122222e+09,<nil>
<nil>,0,0,0,43291,2.516883760429998e+09,<nil>
<nil>,0,0,0,43291,1.6905798333311198e+09,<nil>
<nil>,0,0,0,43291,4.7187180379777775e+09,<nil>
<nil>,0,0,0,43291,2.661028889208894e+09,<nil>
<nil>,0,0,0,43291,2.54171706536667e+09,<nil>
<nil>,0,0,0,43291,2.308612923980002e+09,<nil>
<nil>,0,0,0,43291,2.4616194799533324e+09,<nil>
<nil>,0,0,0,43291,2.5002762265044436e+09,<nil>
<nil>,0,0,0,43291,6.444013357118884e+09,<nil>
<nil>,0,0,0,43291,5.358752624950001e+09,<nil>
<nil>,0,0,0,43291,2.2706710080411186e+09,<nil>
<nil>,0,0,0,43291,1.6619854544155538e+09,<nil>
<nil>,0,0,0,43291,2.622823571585556e+09,<nil>
<nil>,0,0,0,43291,4.378603306601115e+09,<nil>
<nil>,0,0,0,43291,4.061562678224451e+09,<nil>
<nil>,0,0,0,43291,1.8637243523811097e+09,<nil>
<nil>,0,0,0,43291,1.3979381087566655e+09,<nil>
<nil>,0,0,0,43291,2.629889336201108e+09,<nil>
<nil>,0,0,0,43291,1.8635800971488805e+09,<nil>
<nil>,0,0,0,43291,1.4265747204477718e+09,<nil>
<nil>,0,0,0,43291,2.2018306699644427e+09,<nil>
<nil>,0,0,0,43291,1.6367100040655553e+09,<nil>
<nil>,0,0,0,43291,6.479776581331099e+09,<nil>
<nil>,0,0,0,43291,2.729113366425562e+09,<nil>
<nil>,0,0,0,43291,2.471545529040001e+09,<nil>
<nil>,0,0,0,43291,2.208854682815542e+09,<nil>
<nil>,0,0,0,43291,3.7872373276488914e+09,<nil>
<nil>,0,0,0,43291,2.4311202489366674e+09,<nil>
<nil>,0,0,0,43291,2.295793400655568e+09,<nil>
<nil>,0,0,0,43291,2.283401496208885e+09,<nil>
<nil>,0,0,0,43291,1.7566143854955552e+09,<nil>
<nil>,0,0,0,43291,2.3255360011944427e+09,<nil>
<nil>,0,0,0,43291,2.573722486475556e+09,<nil>
<nil>,0,0,0,43291,1.8433781595944445e+09,<nil>
<nil>,0,0,0,43291,1.9622875214399998e+09,<nil>
<nil>,0,0,0,43291,1.8286393538355591e+09,<nil>
<nil>,0,0,0,43291,2.2537162321944437e+09,<nil>
<nil>,0,0,0,43291,4.1161793253410983e+09,<nil>
<nil>,0,0,0,43291,1.640131676604449e+09,<nil>
<nil>,0,0,0,43291,1.843411782271104e+09,<nil>
<nil>,0,0,0,43291,2.7066499551322203e+09,<nil>
<nil>,0,0,0,43291,2.734098517479984e+09,<nil>
<nil>,0,0,0,43291,2.617557317637773e+09,<nil>
<nil>,0,0,0,43291,2.7291273638488894e+09,<nil>
<nil>,0,0,0,43291,3.4084608953066835e+09,<nil>
<nil>,0,0,0,43291,1.7497162051511102e+09,<nil>
<nil>,0,0,0,43291,1.6915353619033327e+09,<nil>
<nil>,0,0,0,43291,2.445755781609999e+09,<nil>
<nil>,0,0,0,43291,2.3514466267166667e+09,<nil>
<nil>,0,0,0,43291,2.0610301557444484e+09,<nil>
<nil>,0,0,0,43291,2.1906711640855594e+09,<nil>
<nil>,0,0,0,43291,2.5139227041311073e+09,<nil>
<nil>,0,0,0,43291,1.690255439437777e+09,<nil>
<nil>,0,0,0,43291,2.6109379313333244e+09,<nil>
<nil>,0,0,0,43291,3.758426301328883e+09,<nil>
<nil>,0,0,0,43291,2.2652428457533245e+09,<nil>
<nil>,0,0,0,43291,4.300737997552219e+09,<nil>
<nil>,0,0,0,43291,1.7645092208622155e+09,<nil>
<nil>,0,0,0,43291,4.236441098026657e+09,<nil>
<nil>,0,0,0,43291,2.1152349130466628e+09,<nil>
<nil>,0,0,0,43291,2.621991278059997e+09,<nil>
<nil>,0,0,0,43291,2.6207193403788886e+09,<nil>
<nil>,0,0,0,43291,2.4705610916999993e+09,<nil>
<nil>,0,0,0,43291,2.585695045435555e+09,<nil>
<nil>,0,0,0,43291,3.5670745497011e+09,<nil>
<nil>,0,0,0,43291,5.266123353261106e+09,<nil>
<nil>,0,0,0,43291,2.3111360196622205e+09,<nil>
<nil>,0,0,0,43291,5.8317773161788845e+09,<nil>
<nil>,0,0,0,43291,1.7385685321455548e+09,<nil>
<nil>,0,0,0,43291,3.163964294359999e+09,<nil>
<nil>,0,0,0,43291,5.405172794632227e+09,<nil>
<nil>,0,0,0,43291,1.5333305188522148e+09,<nil>
<nil>,0,0,0,43291,1.5284922685911138e+09,<nil>
<nil>,0,0,0,43291,2.2521639131366663e+09,<nil>
<nil>,0,0,0,43291,3.580182872096663e+09,<nil>
<nil>,0,0,0,43291,3.568863285719994e+09,<nil>
<nil>,0,0,0,43291,2.53488858353222e+09,<nil>
<nil>,0,0,0,43291,1.729960068694444e+09,<nil>
<nil>,0,0,0,43291,1.8399357073755586e+09,<nil>
<nil>,0,0,0,43291,2.513649105011113e+09,<nil>
<nil>,0,0,0,43291,2.147873537182228e+09,<nil>
<nil>,0,0,0,43291,2.592341656968887e+09,<nil>
<nil>,0,0,0,43291,1.6496733016111095e+09,<nil>
<nil>,0,0,0,43291,1.875871518374438e+09,<nil>
<nil>,0,0,0,43291,5.97167261558888e+09,<nil>
<nil>,0,0,0,43291,2.2490156954144464e+09,<nil>
<nil>,0,0,0,43291,1.7704233486755557e+09,<nil>
<nil>,0,0,0,43291,2.5643821646188903e+09,<nil>
<nil>,0,0,0,43291,2.2159003411666765e+09,<nil>
<nil>,0,0,0,43291,2.5413485627544417e+09,<nil>
<nil>,0,0,0,43291,2.157606700813331e+09,<nil>
<nil>,0,0,0,43291,4.855079444956649e+09,<nil>
<nil>,0,0,0,43291,1.5873676437822185e+09,<nil>
<nil>,0,0,0,43291,4.200892212365559e+09,<nil>
<nil>,0,0,0,43291,2.1393181292566674e+09,<nil>
<nil>,0,0,0,43291,2.702530479774449e+09,<nil>
<nil>,0,0,0,43291,3.0003464889722204e+09,<nil>
<nil>,0,0,0,43291,5.217069407239966e+09,<nil>
<nil>,0,0,0,43291,2.4605253720800014e+09,<nil>
<nil>,0,0,0,43291,3.717905444317788e+09,<nil>
<nil>,0,0,0,43291,1.7441810178911114e+09,<nil>
<nil>,0,0,0,43291,2.493868773695555e+09,<nil>
<nil>,0,0,0,43291,5.643396481577815e+09,<nil>
<nil>,0,0,0,43291,2.796794948735556e+09,<nil>
<nil>,0,0,0,43291,1.785647109836668e+09,<nil>
<nil>,0,0,0,43291,5.390485745668881e+09,<nil>
<nil>,0,0,0,43291,2.265790957914442e+09,<nil>
<nil>,0,0,0,43291,2.1947383054344425e+09,<nil>
<nil>,0,0,0,43291,2.552449096671112e+09,<nil>
<nil>,0,0,0,43291,2.059613626123335e+09,<nil>
<nil>,0,0,0,43291,2.2359584082977796e+09,<nil>
<nil>,0,0,0,43291,2.2105040699155574e+09,<nil>
<nil>,0,0,0,43291,2.466840999867786e+09,<nil>
<nil>,0,0,0,43291,5.827872131271111e+09,<nil>
<nil>,0,0,0,43291,1.8230543338244395e+09,<nil>
<nil>,0,0,0,43291,2.2869488569511113e+09,<nil>
<nil>,0,0,0,43291,2.2627987801966643e+09,<nil>
